111111111111111111111111111111111111111111111111111111111111
100000000000000000000000000000E00000000000000000000000111111
1P00000000000000000000000000000000000000000000000000C1111111
100000000000000000000000000000000000000000000000000000111111
100000000000000000000000000000000000000000000000000000111111
100000000000000000000000000000000000000000000000000000111111
100000000000000000000000000000000000000000000000000000111111
100000000000000000000000000000000000000000000000000000111111
100000000000000000000000000000000000000000000000000000111111
100000000000000000000000000000000000000000000000000000111111
100000000000000000000000000000000000000000000000000000111111
100000000000000000000000000000000000000000000000000000111111
100000000000000000000000000000000000000000000000000000111111
100000000000000000000000000000000000000000000000000000111111
111000101010101110000000000000101011111111111111000000111111
10000000000000000C000000000000000000000000000000001111111111
11111111111111111110000000000011111111C010101011111111111111
10000000000000000000000000000000000000000000000000C111111111
111111111111111111111111111111111111111111111111111111111111
111111111111111111111111111111111111111111111111111111111111
111111111111111111111111111111111111111111111111111111111111
111111111111111111111111111111111111111111111111111111111111
111111111111111111111111111111111111111111111111111111111111
111111111111111111111111111111111111111111111111111111111111