11111111
100000E1
10001011
1P001C01
11001011
100001C1
11111111
