


11111
1C0P1
1CCC1
10E01
11111
