11111111
100000E1
10001011
1P00C001
11001011
100000C1
11111111
