1111111111111111111111111111111111111111111111111111111
100000000000000000000000000000E000000000000000000000001
1P00000000000000000000000000000000000000000000000000C11
1000000000000000000000000000000000000000000000000000001
1000000000000000000000000000000000000000000000000000001
1000000000000000000000000000000000000000000000000000001
1000000000000000000000000000000000000000000000000000001
1000000000000000000000000000000000000000000000000000001
1000000000000000000000000000000000000000000000000000001
1000000000000000000000000000000000000000000000000000001
1000000000000000000000000000000000000000000000000000001
1000000000000000000000000000000000000000000000000000001
1000000000000000000000000000000000000000000000000000001
1000000000000000000000000000000000000000000000000000001
1110001010101011100000000000001010111111111111110000001
10000000000000000C0000000000000000000000000000000011111
11111111111111111110000000000011111111C0101010111111111
10000000000000000000000000000000000000000000000000C1111
1111111111111111111111111111111111111111111111111111111
